#################################################
#................................#.....#.##...#.#
################################.#.#.#.#.##.#.#.#
#.....#...#..........#.........#.#.#.#......#.#.#
#.#.###.#.#.####.###.#.#######.#.#.#.########.#.#
#.#.#...#...##.#.#.#.#.#.....#.#.#.#........#...#
#.###.########.#.#.#.#.#.#####.#.#######.##.#.###
#.......#......#.#.....#.......#............#...#
#.#######.####.#.#######.##################.#.###
#.#...#..........#.......#.......#........#.#...#
#.#.#.###.#.#.##.#.#######.###.###.#.######.###.#
#.#.#...#.#.#..#.#.......#.#...#...#..........#.#
#.#.###.######.#######.###.#.###.##########.###.#
#.#.#.#.###....##....#...#.#...#.###.#.#.##.###.#
#...#.......##.#..##.#.#.#.#.#.....#............#
#.#########.##.#.###.#.#.#.#.#.#####.######.###.#
#.#.......#....#...#...#...#.#.#.....#......#.#.#
#.#.#####.###.####.#########.#.#######.#.####.#.#
#...#...#...#....#.........#...#...#.#.#.##.#...#
#.#.###.###.####.#######.#########.#.#.####.#.###
#S#...#...#....#...#...#...#.....#.#..........#.#
#####.#.#.#.##.###.#.#.###.#.###.#.######.#####.#
#.#.....#.#........#.#...#.#...#..........#.....#
#.#.#########.######.#.###.###.##########.###.#.#
#...#.......#........#.....#...#...#..........#.#
#.#######.#.##################.###.#.#.####.###.#
#.........#..................#...#...#......#.#.#
#############.##.###########.###.#######.####.#.#
#.........#......#.....#.#.#...#.....#......#.#.#
#.#######.#.##.#####.#.#.#.###.#####.########.#.#
#...#.#...#....#...#.#...#...#.#.......#.##...#.#
###.#.#.########.#.#.#####.###.###.#####.####.#.#
#...#.#.#........#...#.........#............#.#.#
#.###.#.#.##########.#.###############.####.#.#.#
#.#.........#......#.#...#...........#......#...#
#.#########.#.####.#.###.###.#######.####.#####.#
#.........#.#......#.........#...#...#....#.#...#
#.#######.###.####.#.#########.###.#.#.####.#.###
#.#.....#.#......#.#.......#.....#.#...#....#...#
#.#.#.###.###.##.#########.#.###.#######.##.#####
#.#.#...#.#.#.##.###.....#.#.#...#...###.##.#...#
#.....#.....#........###...#.#.#...#......#.#.#.#
###.###.###.############.###.#.#########.####.#.#
#.....#.#...#........#...#...#...#.....#......#.#
#.#####.#####.######.#####.#####.#.###.########.#
#.#...#............#.#.....#.....#...#....#.....#
#.###.#####.##.###.#.#.#####.#######.#.##.#.#.###
#.........#....#...#.......#.........#......#..E#
#################################################