###################
#S#...............#
#.#.###.#.#########
#...#...#.........#
#.###.#########.#.#
#.#...#.......#.#.#
#.#####.#####.###.#
#...#.......#.#...#
###.#.#####.#.#.#.#
#...#.#...#.#.#.#.#
###.#.#.#.#.#.#.#.#
#...#...#.#.#...#.#
#.#######.#########
#.......#.#.......#
#####.#.#.#.#####.#
#...#.#.#...#...#.#
#.###.#.#####.#.#.#
#.....#.......#.#E#
###################